0 9 6 6 6 6 6 6 7 2 0 1 2 1 2 0 1 2 0 2
1 5 8 8 8 12 12 12 5 2 8 8 8 2 1 2 1 2 0 1
0 5 8 8 8 8 8 12 5 1 8 8 8 2 2 0 1 0 2 2
2 5 8 8 8 8 8 8 5 2 8 8 8 1 1 0 0 1 0 0
1 3 6 4 8 11 6 6 10 0 8 8 8 1 1 2 2 0 1 0
1 2 0 0 8 1 2 1 1 1 8 8 8 0 1 0 2 1 0 1
0 2 8 8 8 8 8 8 8 8 8 8 8 8 8 8 8 8 8 2
2 2 8 8 8 8 8 8 8 8 8 8 8 8 8 8 8 8 8 0
1 0 8 8 8 8 8 8 8 8 8 8 8 8 8 8 8 8 8 2
2 1 8 8 8 1 2 0 1 2 2 0 8 8 8 0 1 2 1 2
0 0 8 8 8 0 0 2 1 1 0 1 8 8 8 0 1 2 2 1
1 1 8 8 8 8 8 8 8 0 2 0 8 8 8 0 2 0 1 1
0 2 8 8 8 8 8 8 8 1 1 0 8 8 8 1 1 2 0 0
1 1 8 8 8 8 8 8 8 0 0 2 8 8 8 0 0 2 2 0
2 2 8 8 8 1 2 0 1 2 2 2 8 8 8 2 2 0 1 1
1 0 8 8 8 0 2 1 2 0 1 1 8 8 8 1 2 2 0 2
2 0 8 8 8 1 1 2 2 0 1 0 1 1 2 0 0 1 2 0
0 2 8 8 8 1 0 2 1 0 1 2 0 0 0 2 1 0 1 2
0 1 8 8 8 2 0 1 2 1 0 1 2 0 1 2 0 2 2 2
0 1 2 1 0 2 1 2 1 2 0 1 2 1 2 0 1 2 0 2