0 1 2 1 0 2 1 2 1 2 0 1 2 1 2 0 1 2 0 2
1 0 2 1 2 8 8 8 8 1 8 8 8 0 1 2 8 8 8 1
0 2 0 1 8 8 8 8 8 2 8 8 8 8 8 8 8 8 8 2
2 1 0 8 8 8 8 8 8 0 8 8 8 8 8 8 8 8 8 0
1 2 8 8 8 8 8 8 1 2 8 8 8 8 8 8 8 2 1 0
1 8 8 8 8 8 8 1 0 8 8 8 8 8 8 8 1 0 2 1
0 8 8 8 8 8 1 2 8 8 8 8 8 8 8 8 8 8 8 2
2 8 8 8 8 8 0 8 8 8 8 8 8 8 8 8 8 8 8 0
1 8 8 8 8 8 8 8 8 8 8 8 8 8 8 8 8 8 8 2
2 1 8 8 8 8 8 8 8 8 8 8 8 8 8 8 8 8 1 2
0 1 8 8 8 8 8 8 8 8 8 8 8 8 8 8 1 2 0 1
1 2 8 8 8 8 8 8 8 8 8 8 8 8 8 8 8 2 1 1
0 8 8 8 8 8 8 8 8 8 1 8 8 8 8 8 8 0 0 0
1 8 8 8 8 8 8 8 1 2 0 1 8 8 8 8 8 1 2 0
2 1 8 8 8 8 8 8 1 2 2 1 8 8 8 8 8 2 2 1
1 0 8 8 8 8 8 0 1 2 2 0 8 8 8 8 8 8 1 2
2 8 8 8 8 8 8 8 8 1 0 2 1 8 8 8 0 8 8 0
0 2 8 8 8 8 8 8 8 8 0 1 0 2 8 1 0 2 8 2
0 1 0 8 8 8 8 8 8 8 8 8 1 2 0 2 1 0 1 2
0 1 2 1 0 2 12 12 12 12 12 12 12 1 2 0 1 2 0 2