12 12 12 12 12 12 12 12 12 12 12 12 12 12 12 12 12 12 12 12
12 12 8 8 8 8 8 8 8 8 8 8 8 8 8 8 8 8 8 12
12 12 12 12 12 12 12 12 12 12 12 12 12 12 12 12 12 12 12 12
12 12 8 8 8 8 8 8 8 8 8 8 8 8 8 8 8 8 12 12
12 12 8 8 8 8 8 8 8 8 8 8 8 8 8 8 8 8 8 12
12 12 8 12 8 8 12 12 12 12 12 12 12 12 8 8 12 12 12 12
12 12 8 12 8 8 8 8 8 12 12 12 8 8 8 8 12 12 12 12
12 12 8 12 8 8 8 8 12 12 12 12 12 12 12 8 8 8 12 12
12 12 8 12 12 8 8 12 8 8 8 8 8 8 8 8 8 8 12 12
12 8 8 8 8 12 8 12 8 8 8 8 12 12 8 8 8 12 12 12
12 8 8 8 8 12 8 12 8 8 8 8 12 12 12 12 12 12 12 12
12 8 8 8 8 12 8 8 12 12 12 12 8 8 8 8 8 8 12 12
12 12 12 12 12 8 8 8 8 8 8 8 8 8 8 8 8 8 12 12
12 8 12 12 12 12 8 8 8 8 8 8 8 8 8 8 8 8 12 12
12 8 8 8 8 8 8 8 8 8 8 8 8 8 8 8 8 8 12 12
12 8 8 8 8 8 8 8 8 8 8 8 8 8 8 8 8 8 12 12
12 8 8 8 8 8 8 8 8 8 8 8 8 8 8 8 8 8 12 12
12 8 8 8 8 8 8 8 8 8 8 8 8 8 8 8 8 2 12 12
12 8 8 8 8 8 8 8 8 8 8 8 8 8 8 8 8 8 12 12
12 12 12 12 12 12 12 12 12 12 12 12 12 12 12 12 12 12 12 12